#亲友圈邮件配置
#亲友圈邮件标题
clubRewardTitle="第一次加入亲友圈奖励"
clubJoinSucessTitle="亲友圈申请成功"
clubJoinLoseTitle="亲友圈申请失败"
clubKickOutTitle="移出亲友圈通知"
#亲友圈邮件发送者
clubSender="系统"
#亲友圈邮件内容
clubRewardMsgInfo="恭喜您第一次成功加入亲友圈，先特发送房卡数张以资鼓励"
clubJoinLoseMsgInfo="很遗憾，您申请加入%s失败"
clubJoinSucessMsgInfo="恭喜，您申请加入%s成功"
clubKickOutMsgInfo="很遗憾，您被移出%s"

#比赛场奖励通知
arenaTitle="恭喜你，在%s赛中获得%s名奖励"
arenaSender="系统"
arenaMsgInfo="恭喜你，在%s赛中获得%s名，得到了奖励，请领取"
#比赛场专属场创建者
exclusiveTitle="%s赛事已经结束."
exclusiveMsgInfo="你创建的%s赛事已经结束，共%s人报名参赛，您共获得%s%s."
#比赛场房卡回退
arenaGainTitle="%s赛事退还%s."
arenaGainMsgInfo="系统退还您在%s赛事的%s."
#比赛场-红包奖励通知
arenaWishing="恭喜你，在%s赛中获得%s名，请领取奖励。"
arenaSendName="玉山"

#获取奖励通知
activityTitle="恭喜你，在%s活动中获得%s名奖励";
activitySender="系统"
activityMsgInfo="恭喜你，在%s活动中获得%s名，得到了奖励，请领取"

